R 3000 3000
NO ./pics/kita.xpm
EA ./pics/higashi.xpm
SO ./pics/minami.xpm
WE ./pics/nishi.xpm

S ./pics/barrel.xpm
F 170,140,200
C 180,200,220

111111111
1N  2 1 1
1  2  1 1
1   2 1 1
1111111 1