R 640 480
NO ./pics/kita.xpm
EA ./pics/higashi.xpm
SO ./pics/minami.xpm
WE ./pics/nishi.xpm

S ./pics/gyoza.xpm

F 135,172,131
C 126,245,221

111111111111111111111111111111111111111111111111111111111111111111
122222222221222222222122222222212222222222222222221222222222122221
122222222221222222222122222222212222222222222222221222222222122221
122222222221222222222122222222212222222222222222221222222222122221
122222222221222222222122222222212222222222222222221222222222122221
122222222221222222222122222222212222222222222222221222222222122221
122222222221222222222122222222212222222222222222221222222222122221
122222222221222222222122222222212222222222222222221222222222122221
122222222221222222222122222222212222222222222222221222222222122221
122222222221222222222122222222212222222222222222221222222222122221
122222222221222222222122222222212222222222222222221222222222122221
122222222221222222222122222222212222222222222222221222222222122221
122222222221222222222122222222212222222222222222221222222222122221
122222222221222222222122222222212222222222222222221222222222122221
122222222221222222222122222222212222222222222222221222222222122221
122222222221222222222122222222212222222222222222221222222222122221
122222222221222222222122222222212222222222222222221222222222122221
122222222221222222222122222222212222222222222222221222222222122221
122222222221222222222122222222212222222222222222221222222222122221
10000000000000000000000000N000000000000000000000000000000000000001
122222222221222222222122222222212222222222222222221222222222122221
122222222221222222222122222222212222222222222222221222222222122221
122222222221222222222122222222212222222222222222221222222222122221
122222222221222222222122222222212222222222222222221222222222122221
122222222221222222222122222222212222222222222222221222222222122221
122222222221222222222122222222212222222222222222221222222222122221
122222222221222222222122222222212222222222222222221222222222122221
122222222221222222222122222222212222222222222222221222222222122221
122222222221222222222122222222212222222222222222221222222222122221
122222222221222222222122222222212222222222222222221222222222122221
122222222221222222222122222222212222222222222222221222222222122221
122222222221222222222122222222212222222222222222221222222222122221
122222222221222222222122222222212222222222222222221222222222122221
122222222221222222222122222222212222222222222222221222222222122221
122222222221222222222122222222212222222222222222221222222222122221
122222222221222222222122222222212222222222222222221222222222122221
122222222221222222222122222222212222222222222222221222222222122221
122222222221222222222122222222212222222222222222221222222222122221
122222222221222222222122222222212222222222222222221222222222122221
122222222221222222222122222222212222222222222222221222222222122221
122222222221222222222122222222212222222222222222221222222222122221
122222222221222222222122222222212222222222222222221222222222122221
122222222221222222222122222222212222222222222222221222222222122221
122222222221222222222122222222212222222222222222221222222222122221
111111111111111111111111111111111111111111111111111111111111111111