R 2222 2222

NO ./north.xpm
SO ./south.xpm
WE ./west.xpm
EA ./east.xpm
S ./sprite.xpm

F 222,122,2
C 222,222,2

        22222222222222222222222
        21122222111222222222222
        22122222222222222222222
        21122222111222222222222
22222222221122222111211111111
21112111111111211122222210201
21112111111111211121212210001
21222222112121211122222212001
22222222222222221122222210001
22222222222222221121212210002
21222221112121211111211110N0111
11112111 1112121 121111210001
11111111 1111111 111111111111
