R 1920 1080

NO ./north.xpm
SO ./south.xpm
WE ./west.xpm
EA ./east.xpm
S ./sprite.xpm

F 220,-1,0
C 225,30,0

        1111111111111111111111111
        1000000000110000000000001
        1011000001110000002000001
        1001000000000000000000001
111111111011000001110000000000001
100000000011000001110111111111111
11110111111111011100000010001
11110111111111011101010010001
11000000110101011100000010001
111100020000000000000000010001
100000000000000011010100100101
11000001110101011111011110N0111
11110111 1110101 101111010101
11111111 1111111 111111111111
